     WWWW
    WWWWWW
WWWWWW  WW
WC B    WW
WWWWWWW WW
    WWW WW
     WWXWW
      WWW