WWWWWWWWWWW
W    C    W
W  BWWW   W
W B       W
WWW WWW WWW
  WXW WXW
  WWW WWW