WWWWWWWW
W   C  WW
W BB    W
WWWXBW WW
  WXXBXW
  WWWWWW