WWWWWWWW
W   C  WW
W BB  B XW
WWWXBW WW
  WXXBXW
  WWWWWW