  WWWWWWWWWWWW
  W    XX    W
WWW BBWWWWBB W
W   XX C XX  W
W BBWWWWBB WWW
W    XX    W
WWWWWWWWWWWW