WWWWWWWWWWW
W    W    W
W    W    W
W  BXWXB  W
W  XB BX  W
WWWW C WWWW
W  XB BX  W
W  BXWXB  W
W    W    W
W    W    W
WWWWWWWWWWW