WWWWWWWWW
W       W
W XBXBX W
W BXBXB W
W XBCBX W
W BXBXB W
W XBXBX W
W       W
WWWWWWWWW